   #####
####   #
#  #X  ####
# XX      #
#P  #X X# #
### #   # #
 #  ##### #
 #  OOOOO #
 ##########
